rebound.fitness_en-us_?add-to-cart=7195.txt	54 chunks
www.jumpsport.com_44-in-fitness-trampolines_.txt	14 chunks
sunnyhealthfitness.com_products_sunny-health-fitness-gift-card.txt	47 chunks
www.jumpsport.com_blog_.txt	13 chunks
www.bellicon.com_en-us_shopping-cart_.txt	55 chunks
sunnyhealthfitness.com_collections_weight-plates.txt	43 chunks
support.jumpsport.com_article_29-privacy-policy.txt	128 chunks
www.jumpsport.com_recalls_.txt	8 chunks
bcantrampolines.com_#ProductInfo-template--21727353831729__1658145509cdb7a0e8.txt	24 chunks
www.bellicon.com_en-us_store_#list-equipment-spares.txt	65 chunks
www.jumpsport.com_fitness-sign-up_.txt	5 chunks
sunnyhealthfitness.com_products_smart-magnetic-rower-with-dual-slide-rail-sf-rw523021.txt	94 chunks
sunnyhealthfitness.com_pages_influencer-program.txt	41 chunks
sunnyhealthfitness.com_blogs_index.txt	72 chunks
rebound.fitness_en-us_#slide-out-widget-area.txt	55 chunks
sunnyhealthfitness.com_products_smart-magnetic-resistance-exercise-bike-with-dumbbell-holder-sf-b123033.txt	119 chunks
sunnyhealthfitness.com_collections_more-strength-products.txt	67 chunks
jumpsportcostarica.com_.txt	3 chunks
rebound.fitness_en-us_shop_bycategory_rebounders_.txt	22 chunks
sunnyhealthfitness.com_pages_2025-valentines-day-deals?utm_source=homepagebanner.txt	185 chunks
rebound.fitness_en-us_mini-trampoline-instructor-training-courses_meet-our-instructors_.txt	212 chunks
sunnyhealthfitness.com_collections_plyo-boxes.txt	52 chunks
www.jumpsport.com_gift-guide_.txt	77 chunks
www.jumpsport.com_jumpsport-fitness-training-request_.txt	6 chunks
www.bellicon.com_en-us_sign-in_.txt	52 chunks
www.jumpsport.com_rebounder-accessories_.txt	26 chunks
sunnyhealthfitness.com_pages_sunny-strength.txt	45 chunks
rebound.fitness_my-account_.txt	12 chunks
www.bellicon.com_en-us_shipping-and-delivery_.txt	75 chunks
sunnyhealthfitness.com_collections_roman-chairs.txt	51 chunks
www.jumpsport.com_39-in-fitness-trampolines_.txt	28 chunks
sunnyhealthfitness.com_collections_strengthen.txt	84 chunks
rebound.fitness_en-us_shop_bycategory_instructor-training_.txt	21 chunks
rebound.fitness_en-us_when-to-rebound-using-a-stability-handle-bar_.txt	47 chunks
sunnyhealthfitness.com_blogs_products.txt	62 chunks
sunnyhealthfitness.com_collections_under-desk-treadpad-treadmills.txt	61 chunks
rebound.fitness_en-us_why-rebounding-burns-more-calories_.txt	42 chunks
leapsandrebounds.com_cart.txt	12 chunks
sunnyhealthfitness.com_search?q=strength.txt	99 chunks
sunnyhealthfitness.com_{{product.url}}.txt	41 chunks
sunnyhealthfitness.com_collections_resistance-bands.txt	59 chunks
rebound.fitness_en-us_warranty-registration_.txt	39 chunks
www.bellicon.com_en-us_disclaimer_.txt	108 chunks
sunnyhealthfitness.com_pages_shipping-policy.txt	61 chunks
sunnyhealthfitness.com_products_full-body-adjustable-multi-function-smart-row-n-ride-trainer-sf-a022070.txt	84 chunks
sunnyhealthfitness.com_collections_power-racks.txt	59 chunks
rebound.fitness_en-us_about-rebounding_rebound-at-home_.txt	52 chunks
sunnyhealthfitness.com_account_.txt	41 chunks
rebound.fitness_en-us_contact_.txt	27 chunks
sunnyhealthfitness.com_collections_weight-racks.txt	51 chunks
sunnyhealthfitness.com_collections_recumbent-bikes.txt	61 chunks
leapsandrebounds.com_products_male-black-shorts.txt	18 chunks
rebound.fitness_en-us_benefits-of-rebounding_.txt	214 chunks
bcantrampolines.com_pages_warranty.txt	14 chunks
sunnyhealthfitness.com_pages_rewards.txt	61 chunks
sunnyhealthfitness.com_pages_sunny-careers.txt	58 chunks
bcantrampolines.com_pages_paymeny-policy.txt	8 chunks
leapsandrebounds.com_blogs_mini-trampoline-workouts.txt	82 chunks
sunnyhealthfitness.com_collections_cardio-climber-training-machine.txt	62 chunks
rebound.fitness_en-us_about-rebounding_the-benefits-of-rebounding_.txt	153 chunks
leapsandrebounds.com_pages_comparisons.txt	16 chunks
sunnyhealthfitness.com_collections_dip-stations.txt	43 chunks
sunnyhealthfitness.com_products_smart-pro-indoor-cycling-exercise-bike-sf-b901smart.txt	111 chunks
www.bellicon.com_en-us_magazine_sport_trampoline-online-training-bellicon+_.txt	109 chunks
www.jumpsport.es_.txt	38 chunks
www.jumpsport.com_fitness-trampolines_.txt	11 chunks
sunnyhealthfitness.com_#swym-wishlist.txt	111 chunks
www.bellicon.com_en-us_lp_bellicon-affiliate-program_.txt	84 chunks
sunnyhealthfitness.com_search?q=stepper.txt	76 chunks
sunnyhealthfitness.com_cart.txt	124 chunks
bcantrampolines.com_cart.txt	13 chunks
www.bellicon.com_en-us_magazine_health_cancer-aftercare-bellicon_.txt	105 chunks
bcantrampolines.com_collections_max-load-170lbs-300lbs.txt	17 chunks
bcantrampolines.com_collections_trampoline-for-kids.txt	24 chunks
rebound.fitness_en-us_shop_rebounders_bungee-rebounders-en-us_maximus-pro-bungee-mini-trampoline_.txt	104 chunks
sunnyhealthfitness.com_collections_yoga-and-exercise-mats.txt	55 chunks
sunnyhealthfitness.com_collections_classic-strength.txt	57 chunks
bcantrampolines.com_#Slide-template--21727353831729__9c0a2aeb-9cba-4c2d-afdb-c5c9bd075980-1.txt	24 chunks
sunnyhealthfitness.com_#MainContent.txt	112 chunks
sunnyhealthfitness.com_collections_air-rowers.txt	43 chunks
sunnyhealthfitness.com_collections_rowing-machines.txt	66 chunks
rebound.fitness_en-us_workout-videos_.txt	38 chunks
www.jumpsport.com_jumpsport-folding-fitness-trampolines-39-or-44_.txt	46 chunks
sunnyhealthfitness.com_collections_standard-treadmills.txt	48 chunks
sunnyhealthfitness.com_blogs_trainers.txt	59 chunks
www.jumpsport.com_.txt	20 chunks
sunnyhealthfitness.com_pages_where-to-buy.txt	41 chunks
sunnyhealthfitness.com_products_smart-upright-row-n-ride-exerciser-no-077smart.txt	115 chunks
sunnyhealthfitness.com_collections_rower-tension-system-magnetic.txt	48 chunks
www.bellicon.com_en-us_returns_.txt	74 chunks
rebound.fitness_en-us_shop_rebounders_bungee-rebounders-en-us_fit-bounce-pro-xl-bungee-sprung-rebounder_.txt	101 chunks
www.jumpsport.com_brighten-your-life_.txt	77 chunks
sunnyhealthfitness.com_pages_press.txt	96 chunks
rebound.fitness_en-us_about-rebounding_rebounding-for-schools_.txt	169 chunks
sunnyhealthfitness.com_collections_essentials.txt	65 chunks
www.jumpsport.fr_.txt	36 chunks
www.jumpsport.com_fitness-clearance-deals_.txt	16 chunks
sunnyhealthfitness.com_pages_warranty.txt	80 chunks
sunnyhealthfitness.com_collections_features-resistance-bands.txt	53 chunks
sunnyhealthfitness.com_collections_fitness-essentials.txt	45 chunks
bcantrampolines.com_#Slide-template--21727353831729__9c0a2aeb-9cba-4c2d-afdb-c5c9bd075980-2.txt	24 chunks
www.bellicon.com_en-us_.txt	75 chunks
sunnyhealthfitness.com_collections_strength-attachments.txt	49 chunks
sunnyhealthfitness.com_collections_weights-accessories.txt	47 chunks
www.jumpsport.com_premier-partner_.txt	5 chunks
leapsandrebounds.com_products_leaps-rebounds-socks.txt	20 chunks
sunnyhealthfitness.com_collections_upright-bikes.txt	61 chunks
leapsandrebounds.com_pages_terms-of-service.txt	80 chunks
support.sunnyhealthfitness.com_hc_en-us_requests_new.txt	1 chunks
sunnyhealthfitness.com_products_manual-incline-smart-treadmill-sf-t4400smart.txt	115 chunks
www.bellicon.com_en-us_store_#list-equipment-trampoline.txt	65 chunks
sunnyhealthfitness.com_collections_steppers-with-handlebar.txt	52 chunks
sunnyhealthfitness.com_.txt	109 chunks
leapsandrebounds.com_pages_no-risk-money-back-guarantee.txt	22 chunks
leapsandrebounds.com_products_bungee-rebounders-mini-trampoline?size=48.txt	70 chunks
rebound.fitness_en-us_category_weight-loss-en-us_.txt	12 chunks
leapsandrebounds.com_pages_about-our-trampolines.txt	19 chunks
sunnyhealthfitness.com_collections_get-moving.txt	67 chunks
leapsandrebounds.com_.txt	17 chunks
sunnyhealthfitness.com_collections_ab-core-training-equipment.txt	79 chunks
rebound.fitness_en-us_?add-to-cart=80964.txt	54 chunks
sunnyhealthfitness.com_pages_app?utm_source=header&utm_medium=announcement.txt	138 chunks
rebound.fitness_en-au_.txt	54 chunks
sunnyhealthfitness.com_products_pro-smart-magnetic-elliptical-trainer-16-in-stride-sf-e323038.txt	73 chunks
sunnyhealthfitness.com_pages_wholesale.txt	41 chunks
www.jumpsport.com_fitness_compare-fitness-trampolines_.txt	31 chunks
www.jumpsport.com_2023-fitness-guide_.txt	77 chunks
sunnyhealthfitness.com_collections_special-treadmills.txt	43 chunks
sunnyhealthfitness.com_pages_terms-of-use.txt	141 chunks
www.jumpsport.com_cart.php.txt	5 chunks
bcantrampolines.com_collections_450-550-lbs.txt	30 chunks
rebound.fitness_en-us_about-rebounding_rebounding-in-gyms_.txt	118 chunks
sunnyhealthfitness.com_pages_return-policy.txt	70 chunks
www.bellicon.com_en-us_data-protection_.txt	163 chunks
bcantrampolines.com_policies_privacy-policy.txt	134 chunks
rebound.fitness_en-us_shop_rebounders_bungee-rebounders-en-us_fit-bounce-pro-2-bungee-sprung-rebounder_.txt	112 chunks
www.jumpsport.com_jumpsport-fitness-press_.txt	6 chunks
sunnyhealthfitness.com_pages_faq.txt	90 chunks
sunnyhealthfitness.com_pages_contact-us.txt	1 chunks
leapsandrebounds.com_collections_accessories.txt	13 chunks
sunnyhealthfitness.com_products_smart-magnetic-elliptical-sf-e905smart.txt	111 chunks
support.jumpsport.com_article_74-fitness-trampoline-user-manuals.txt	12 chunks
sunnyhealthfitness.com_collections_stationary-indoor-cycling-bikes.txt	53 chunks
rebound.fitness_.txt	55 chunks
rebound.fitness_en-us_rebounding-retreats_.txt	36 chunks
sunnyhealthfitness.com_collections_home-gym-equipment.txt	43 chunks
sunnyhealthfitness.com_pages_register-affiliate-account.txt	41 chunks
leapsandrebounds.com_products_bungee-rebounders-mini-trampoline#reviews.txt	70 chunks
rebound.fitness_en-us_about-rebounding_.txt	153 chunks
sunnyhealthfitness.com_{{ item.url }}.txt	41 chunks
sunnyhealthfitness.com_pages_wishlist.txt	43 chunks
bcantrampolines.com_#MainContent.txt	24 chunks
sunnyhealthfitness.com_{{item.url}}.txt	41 chunks
sunnyhealthfitness.com_search?q=bike.txt	96 chunks
bcantrampolines.com_pages_contact-us.txt	9 chunks
bcantrampolines.com_collections_max-load-330-440-lbs.txt	17 chunks
www.jumpsport.com_bread-financing.txt	9 chunks
sunnyhealthfitness.com_collections_rower-tension-system-hydraulic.txt	43 chunks
leapsandrebounds.com_products_stability-bar.txt	24 chunks
www.jumpsport.mx_.txt	54 chunks
rebound.fitness_en-us_shop_bycategory_spare-parts_.txt	21 chunks
www.jumpsportfitness.co.nz_.txt	27 chunks
rebound.fitness_en-us_contact-us_.txt	27 chunks
support.jumpsport.com_article_164-become-a-reseller.txt	1 chunks
www.jumpsport.com_about-us_.txt	37 chunks
leapsandrebounds.com_pages_community.txt	16 chunks
www.jumpsport.com_fitness-trampoline-workouts_.txt	16 chunks
www.jumpsport.com_fitness-trampoline-club-studio-locator_.txt	6 chunks
rebound.fitness_en-us_shop_rebounders_spring-fitness-trampolines-en-us_maximus-pro-rebounder-mini-trampoline_.txt	104 chunks
bcantrampolines.com_policies_shipping-policy.txt	15 chunks
sunnyhealthfitness.com_blogs_fitness-programs.txt	65 chunks
www.jumpsport.com_limited-editions-trampolines_.txt	24 chunks
sunnyhealthfitness.com_collections_treadmills.txt	70 chunks
leapsandrebounds.com_collections_bungees.txt	47 chunks
rebound.fitness_en-us_which-rebounder-should-i-buy_.txt	86 chunks
rebound.fitness_en-us_.txt	55 chunks
www.jumpsport.com_mini-trampoline-replacement-parts_.txt	19 chunks
leapsandrebounds.com_collections_apparel.txt	14 chunks
www.bellicon.com_en-us_store_#list-gifts.txt	65 chunks
sunnyhealthfitness.com_collections_trampolines.txt	61 chunks
leapsandrebounds.com_pages_shipping-policy.txt	14 chunks
sunnyhealthfitness.com_products_multi-purpose-air-drive-adjustable-standing-desk-sf-a023001.txt	66 chunks
leapsandrebounds.com_pages_faqs.txt	43 chunks
sunnyhealthfitness.com_collections_jump-ropes.txt	52 chunks
rebound.fitness_en-us_about-rebounding_faqs_.txt	72 chunks
leapsandrebounds.com_pages_refund-policy.txt	13 chunks
rebound.fitness_en-us_bungee-or-spring-rebounder-what-is-the-difference_.txt	132 chunks
sunnyhealthfitness.com_collections_power-towers.txt	43 chunks
sunnyhealthfitness.com_collections_commercial-grade-treadmills.txt	44 chunks
www.jumpsport.com_jumpsport-fitness-affiliate-program_.txt	10 chunks
www.jumpsport.com_fitness-clubs.txt	25 chunks
support.jumpsport.com_article_169-accessibility-statement.txt	7 chunks
leapsandrebounds.com_pages_privacy-policy.txt	38 chunks
rebound.fitness_en-us_about-rebounding_blog_.txt	33 chunks
jumpsportfitness.de_.txt	174 chunks
rebound.fitness_en-us_shop_bycategory_accessories-en-us_.txt	17 chunks
sunnyhealthfitness.com_pages_app.txt	137 chunks
sunnyhealthfitness.com_collections_row-n-ride.txt	55 chunks
sunnyhealthfitness.com_collections_strength.txt	82 chunks
sunnyhealthfitness.com_collections_twist-steppers.txt	43 chunks
sunnyhealthfitness.com_products_upright-row-n-ride-exercise-bike-sf-a022077.txt	62 chunks
www.bellicon.com_en-us_store_.txt	65 chunks
sunnyhealthfitness.com_collections_vibration-plate.txt	44 chunks
sunnyhealthfitness.com_collections_high-intensity-cardio-fitness-equipment.txt	83 chunks
bcantrampolines.com_pages_faqs.txt	14 chunks
sunnyhealthfitness.com_collections_classic-cardio.txt	74 chunks
leapsandrebounds.com_products_american-tough-rebounder.txt	25 chunks
rebound.fitness_en-us_?add-to-cart=80945.txt	54 chunks
www.jumpsport.it_.txt	37 chunks
www.jumpsport.com_certification-request_.txt	6 chunks
rebound.fitness_ce_.txt	55 chunks
rebound.fitness_en-us_terms-conditions.txt	239 chunks
sunnyhealthfitness.com_collections_parts.txt	60 chunks
sunnyhealthfitness.com_pages_sitemap.txt	45 chunks
sunnyhealthfitness.com_collections_recumbent-cross-trainer-elliptical.txt	54 chunks
sunnyhealthfitness.com_products_premium-smart-treadmill-with-auto-incline-sf-t7515smart.txt	122 chunks
www.jumpsport.com_fitness-testimonials_ .txt	47 chunks
www.bellicon.com_en-us_training-platform_.txt	80 chunks
sunnyhealthfitness.com_pages_about-us.txt	53 chunks
www.jumpsport.pt_.txt	36 chunks
www.jumpsportfitness.com.au_.txt	27 chunks
bcantrampolines.com_products_bcan-mini-trampoline.txt	17 chunks
sunnyhealthfitness.com_pages_accessibility-statement.txt	51 chunks
sunnyhealthfitness.com_pages_best-deals-for-fitness-and-exercise-equipment.txt	99 chunks
sunnyhealthfitness.com_collections_glutes.txt	67 chunks
sunnyhealthfitness.com_collections_wrist-weights.txt	43 chunks
sunnyhealthfitness.com_collections_under-desk-bikes.txt	61 chunks
sunnyhealthfitness.com_collections_fan-bikes.txt	51 chunks
rebound.fitness_en-us_klarna-faqs_.txt	37 chunks
www.bellicon.com_en-us_magazine_.txt	70 chunks
rebound.fitness_en-us_privacy-policy.txt	150 chunks
sunnyhealthfitness.com_pages_sunny-cardio.txt	44 chunks
rebound.fitness_en-us_reviews_.txt	12 chunks
sunnyhealthfitness.com_products_premium-smart-stepper-stair-climber-sf-x7300smart.txt	71 chunks
sunnyhealthfitness.com_collections_strength-racks-cages.txt	56 chunks
leapsandrebounds.com_collections_sale.txt	18 chunks
sunnyhealthfitness.com_collections_stretch-machines.txt	43 chunks
leapsandrebounds.com_pages_benefits.txt	20 chunks
www.bellicon.com_en-us_facts-and-figures_.txt	68 chunks
www.jumpsport.com_Patents_.txt	26 chunks
www.bellicon.com_en-us_safety-instructions_.txt	108 chunks
bcantrampolines.com_policies_refund-policy.txt	14 chunks
sunnyhealthfitness.com_collections_ellipticals_TraditionalElliptical.txt	64 chunks
leapsandrebounds.com_products_the-leaps-rebounds-official-t-shirts-limited-time-only.txt	20 chunks
sunnyhealthfitness.com_collections_2025-valentines-day-special?utm_source=announcementbar.txt	75 chunks
www.bellicon.com_en-us_trampoline_.txt	70 chunks
leapsandrebounds.com_products_bungees-for-leaps-rebounds.txt	21 chunks
rebound.fitness_en-us_mini-trampoline-instructor-training-courses_.txt	282 chunks
sunnyhealthfitness.com_pages_sign-up.txt	48 chunks
leapsandrebounds.com_blogs_news.txt	19 chunks
sunnyhealthfitness.com_pages_product-comparison-charts.txt	41 chunks
www.bellicon.com_en-us_benefits_.txt	60 chunks
sunnyhealthfitness.com_collections_steppers.txt	62 chunks
rebound.fitness_en-us_delivery-and-returns_.txt	79 chunks
www.bellicon.com_en-us_general-terms-and-conditions_.txt	111 chunks
sunnyhealthfitness.com_collections_bikes.txt	71 chunks
bcantrampolines.com_.txt	24 chunks
support.jumpsport.com_.txt	7 chunks
bcantrampolines.com_policies_terms-of-service.txt	77 chunks
sunnyhealthfitness.com_collections_ab-rollers-exercise-wheels.txt	49 chunks
leapsandrebounds.trysaral.com_.txt	1 chunks
sunnyhealthfitness.com_pages_ccpa-access-deletion-request-form.txt	47 chunks
rebound.fitness_en-us_shop_bycategory_dvds-en-us-2_.txt	15 chunks
bcantrampolines.com_pages_about-us.txt	12 chunks
sunnyhealthfitness.com_pages_reviews.txt	119 chunks
sunnyhealthfitness.com_account_login.txt	41 chunks
www.jumpsport.com_fitness_trampoline-workouts_.txt	16 chunks
www.jumpsport.co.za_.txt	36 chunks
sunnyhealthfitness.com_collections_smith-machines.txt	44 chunks
rebound.fitness_en-us_#ajax-content-wrap.txt	55 chunks
www.jumpsport.com_fitness-guide_.txt	77 chunks
leapsandrebounds.com_products_bungee-rebounders-mini-trampoline.txt	70 chunks
www.jumpsport.com_fitness_benefits-of-rebounding_.txt	95 chunks
sunnyhealthfitness.com_products_{{product.handle}}.txt	1 chunks
sunnyhealthfitness.com_collections_kettlebells.txt	53 chunks
sunnyhealthfitness.com_search?q=treadmills.txt	85 chunks
www.jumpsport.com_office-movement_.txt	13 chunks
support.jumpsport.com_category_10-returns.txt	3 chunks
sunnyhealthfitness.com_pages_assembly-guides.txt	57 chunks
rebound.fitness_en-us_cart_.txt	10 chunks
www.jumpsport.com_fitness-trampoline-sale_.txt	22 chunks
www.jumpsport.com_39-in-fitness-trampolines.txt	28 chunks
sunnyhealthfitness.com_blogs_nutrition.txt	65 chunks
sunnyhealthfitness.com_blogs_health-wellness.txt	65 chunks
sunnyhealthfitness.com_blogs_trainers_.txt	59 chunks
bcantrampolines.com_pages_intellectual-property-rights.txt	7 chunks
sunnyhealthfitness.com_products_smart-twist-stepper-machine-sf-s0979smart.txt	98 chunks
sunnyhealthfitness.com_collections_under-desk-ellipticals.txt	63 chunks
www.jumpsport.com_help_orders_.txt	7 chunks
www.bellicon.com_en-us_magazine_health_bellicon-fitnessstudio_.txt	115 chunks
www.bellicon.com_en-us_store_#list-equipment-training.txt	65 chunks
www.bellicon.com_en-us_our-history_.txt	72 chunks
rebound.fitness_en-us_?add-to-cart=7166.txt	54 chunks
rebound.fitness_en-us_category_benefits-of-rebounding_.txt	19 chunks
sunnyhealthfitness.com_pages_payment-info-policy.txt	46 chunks
sunnyhealthfitness.com_pages_privacy-policy.txt	274 chunks
sunnyhealthfitness.com_pages_share-sunny.txt	71 chunks
support.sunnyhealthfitness.com_hc_en-us.txt	1 chunks
sunnyhealthfitness.com_collections_dumbbells.txt	52 chunks
rebound.fitness_en-us_about-rebounding_rebound-therapy-2_.txt	190 chunks
sunnyhealthfitness.com_collections_home-cardio-equipment.txt	73 chunks
sunnyhealthfitness.com_products_sunny-health-and-fitness-no-082-universal-bike-mount-clamp-holder-for-phone-and-tablet.txt	94 chunks
sunnyhealthfitness.com_collections_benches-chairs-tables.txt	64 chunks
sunnyhealthfitness.com_collections_ellipticals.txt	72 chunks
leapsandrebounds.com_pages_contact-us.txt	11 chunks
www.bellicon.com_en-us_trainer_.txt	60 chunks
www.jumpsport.com_trampoline-workout-video_.txt	27 chunks
rebound.fitness_en-us_category_equipment-faq-en-us_.txt	18 chunks
sunnyhealthfitness.com_pages_scam-alert-warning.txt	47 chunks
sunnyhealthfitness.com_collections_barbells.txt	58 chunks
bcantrampolines.com_blogs_news.txt	27 chunks
sunnyhealthfitness.com_collections_rower-tension-system-water.txt	44 chunks
sunnyhealthfitness.com_products_foldable-auto-incline-treadmill-with-20-running-belt-brushless-motor-sf-t723030.txt	122 chunks
sunnyhealthfitness.com_pages_troubleshooting-guides.txt	58 chunks
